


                   NO test_nord

C                        11,150,95

     


WE                   test_ouest
EA test_est           


SO test_sud

F 255,255,10


               111111111111111111111111111111111
               100000000000000000000000000000001
               100000000000000000000000000000001
               1000000000000000N0000000000000001
               100000000000000000000000000000001    111
               100000000000000000000000000000001    101
               100000000000000000000000000000001    101
               111111111111000000000000000000001111110111111111111
                          1000000000000000000000000000000000000001
                          1000000000000000000000000000000000000001
                          1000000000000000000000000000000000000001
                          1000000000000000000000000000000000000001
                          1000000000000000000000000000000000000001
                          1111111111111111111111111111111111111111