NO test_nord


SO test_sud



WE                   test_ouest
EA test_est           



F 255,10,10
C                        0,150,95




 




                   1       11                                          
                 110111111101111111111111               
                 100000000001 100000000001
                 100000000000100N00000001               
                 111111000011111111111111 
                      111111111111               
                 111111111111111111111111
                 10001               1001
                 10001               1001
                 10001               1001
                 10001               1001
                 10001               1001
                 10001               1001
                 10001               1001
                 11111               1111
                 11111               1111