NO test_nord


SO test_sud



WE                   test_ouest
EA test_est           



F 255,10,10
C                        0,150,95



                   1       11
                 11W111111101111111111111
                 100000000000000000000001
                 111111000011111111111111
                       11111111111