


                   NO test_nord

C                        0,150,95

     


WE                   test_ouest
EA test_est           


SO test_sud

F 255,255,10















               111111111111 1111111111111                                          
               100000000001 1000000N00001
               100000000001 1000000000001
               111111111111 1111111111111
               


               
               111111111111 1111111111111
               100000000001 1000000000001
               100000000001 1000000000001
               111111111111 1111111111111





